     W                      
     W           SSSSSSSSSSS
SSSSSWSSSSSH----H          S
S    W     H P  H   E      S
#####H######################
##H  H  H###    ####      ##
#HH#####H### ## ############
#H###### H## G# ### ##  ## #
#H# ### #H## ## ### G### G #
#H## G ##H##    ### ## G## #
#H#######H#########X########
#H  # #G HH              EH#
#H####### H########H######H#
#H G###   H      ##H      H#
#H      E H   G  ##H   G  H#
############################
