#####W################# ####
    #W# -------            #
W##W W# #G   #H#         E #
W ##### ######H#####G #H####
#W    G---####H########H# ##
#######   #  #H### ####H# ##
       E     #H### ## #H#G #
H#######H#HG #H### ## #H####
H       H#####H###G # #H## #
H         ####H###### #H##G#
H       #     H        H   #
H###H####H#S#S#S#S#S#S#H#S#S
H###H####H######  #####H#S#S
H   H    H#######  ####H    
H########H########G #######H
HP       H G ######  E     H
