GGG----GGG GGG-----------GGG
###    ###H###           ###
###    ###H###           ###
###    ###H###    GGG    ###
###    ###H###    ###    ###
###    ###H###    ###    ###
###    ###H###    ###    ###
###    ###H###    ###    ###
###    ###H###    ###    ###
###G--G###H###G--G###G--G###
####GG####H####GG#####GG####
##########H#################
 ######## H ####### ####### 
  ######  H  #####   #####  
   E     PH          E      
############################
