   G      - -  E   -      -E
H### H####G#G#####H -    - H
H  G H############H -G - G H
H### H##G#####G###H-  - - -H
H  G H############H G   G  H
H### H#G#######G##H --  -  H
H  G H############H - G -G-H
H### H##G#####G###H   -  - H
H  G H############H  - -   H
H### H###G###G####H-  - - -H
H  G H############H  G   - H
H### H####G#G#####H   -- G H
H  G H############H -  - - H
H### H###G###G####H G - - -H
H E  H############H     P   
H####H##G#####G###H#########
