W          #################
W          ########S ------#
W    G   H#    G   SH # G  #
#########HS####### SH ######
    G    HS    G   SH ######
H#########S ##X### SH ######
H    EG   S      G SH   E   
#########HS ##XXX# ########H
 G       HS    G           H
H#########S ##X###         H
H  G      S      G         H
#########HS ##XXX#  #####  H
        GHS      G  #  G#  H
H#########S ##X###    H##  H
H   E       P         H# G H
############################
