-----------------------H    
  G    G     G     G   H    
####  ####  ###X  ##X# H    
     G    G      G     H    
#  #X##  ##X#  X###  # H    
 G      G   G      G   H    
####  ####  ###X  ##X# H    
    G     G     G      H    
#  ##X#  #X##  X###  # H    
  G     G     G    G   H    
####  ####  ###X  ##X# H    
E    P           E     H   E
########################W###
########################W###
######################  W  #
###################### EWE #
