             W              
             W              
G            WW            G
#H H----------W---------H H#
##HH E                G HH##
###H H------ ---------H H###
####HH G              HH####
####XH H------ -----HEHX####
####X#HH          G HH#X####
####X##H H--- ----H H##X####
####X###HH G      HH###X####
####X####H H-- -H H####X####
####X#####HH    HH#####X####
####X######H    H######X####
####X#######HPGH#######X####
####E       H##H        ####
