W              #############
W  G     G     #############
##############H  G          
###########################H
     G E   E G             H
H###########################
H        G          G       
###########################H
    G        G      G      H
H###########################
H   G  E E  E     G         
###########################H
   G      G      G      G  H
H###########################
H     G           G  P      
############################
