             EG             
           ########H   E G  
       E G         H#H#####H
     G#####H       H H     H
###X###    H-------H HG    H
           H       H #######
 G         H       H        
###H#######H       H--------
G  H   E   H    G  H       G
#########  ########H    ####
       G   G       H        
#####H###X###H  G  H   G    
     H       ##############H
     H                     H
     H G   P      G        H
############################
