            E          E    
XHXHXHXHXHXHXHXHXHXHXHXHXHXW
XHXHXHXHXHXHXHXHXHXHXHXHXHXW
GH#H H#HGH#H H#HGH#H H#HGH#W
XH#HXH#HXH#HXH#HXH#HXH#HXH#W
XH#HXH#HXH#HXH#HXH#HXH#HXH#W
XH#HXH#HXH#HXH#HXH#HXH#HXH#W
 H#HGH#H H#HGH#H H#HGH#H H#W
XH#HXH#HXH#HXH#HXH#HXH#HXH#W
XH#HXH#HXH#HXH#HXH#HXH#HXH#W
GH H H H H H H H H H H H H#W
H##########################W
H         G E G   G E      W
HSSSSSSSSSSSSSSSSSSSSSSSSSSW
HG       P                GW
############################
