                           W
----------    G            W
H G      H##########H      W
#####H   H          HSSSSSSS
     H E H     G    H       
     H######H#####H##       
  G  H      H     H  --     
####H#      H  E  H    --   
    H    H######H##      --G
    H----H      H  E       #
    H       H#########H     
    H       H#########H     
###H##########   G   #####H#
###H########## H###H #####H#
   H      P    H###H   G  H 
############################
