W                           
W---------------------------
H# E   #             #     #
H #####               ##### 
H # ###               #G### 
H ##### E    E      E ##### 
H ### #X################# # 
H #####X### G## G########H# 
H #####X#################H# 
H #####X#################H# 
H #####X####    #########H# 
H #####X####    #########H# 
H #####X####   GH########H# 
H           ####H--------H  
H          SSSS             
H      P  SSSS      E       
