#    -     P    -    # G    
####H ########## H#### ####H
####H #  ##### # H####   G H
#G##H # #####  # H##G# H####
####H #  ##### # H#### HG   
##G#H # #####  # H#G## ####H
####H #  ##### # H####    GH
#G##H # #####  # H#### H####
####H #  ##### # H ### H G  
##G#H # #####  # H#### ####H
####H #   #### # H#G##  G  H
#G##H #G#####GG# H#### H####
####H ########## H##G  H  G 
##G#H ########## H#### ####H
####H  E     E   H####  E  H
############################
