H E ##          ------------
H#####       ##H            
H#####       ##H #S#S#S#S#S#
H#####       ##H G G G G G G
H##G##       ##H#X#X#X#X#X#X
H##### G  E  ##H#X#X#X#X#X#X
H##############H------------
H##############H   S S S S S
H  P E         H   #X#X#X###
H########H########H     X###
H########H   #####H####HX###
H########H##G  ###H####HX###
H########H####G  #H E  HX###
         H######  H####HX###
    G G  H########H####HX###
##################H GG HX###
