###########################W
#   HHHHHHHHHHHHHHHHHHH   #W
# P H HHH    H   HH   H E #W
####H HHH HH H HH H HHH####W
#   H HHH HH H HH H   H   #W
# E H HHH HH H HH H HHH E #W
####H   H    H   HH   H####W
HHHHHHHHHHHHHHHHHHHHHHHHHHHW
H G H G H G  H  G H G H G HW
HHHHHHHHHHHHHHHHHHHHHHHHHHHW
H   H H H HH H HH H   H   HW
H H H H H  H H  H H HHH H HW
H  HH H H H  H H  H   H  HHW
H H H H H HH H HH H HHH H HW
H H H   H HH H HH H   H H HW
HHHHHHHHHHHHHHHHHHHHHHHHHHHW
