-----------                 
           H     #   - -    
  G  G  G EH---- #### H ####
###########     H#### H X###
GG       GG ----H#### H X###
##G     G##H     # ## H XGG#
###G   G###H---- # ## H X###
####G G####     H# ## H XGG#
#####G#####  E  H# ## H X###
###########H######GG# H XGG#
           H     #### H X###
#W#    P   H         EH XGG#
#W###########H##########X###
#W    ###G###H#####G        
#W    ####G##H##G G##H     G
#WG  G#####  H  ############
