            H##H            
          EGH##HGE          
          H######H          
         GH######HG         
        H##########H        
      EGH##########HGE      
      H##############H      
     GH   GGGGGGGG   HG     
    H##################H    
   GH##################HG   
  H######################H  
  H######################H  
  H                      H  
  H                      H  
  H          P           H  
############################
