          G              W  
        H#######  G      W  
    G   H      ######    W  
##########H         G    W  
          H######W#####H##  
E         H      W     H    
##########H      W E   H   G
##########H#######SS   H####
##########H            H    
##########H       G ---H    
##      ##H       ##   H    
##  GG  ##H     G      H    
###########H#######H   H    
           H       ########H
    G    P H               H
############################
