                  E         
###########################W
G E     #       G  # G     W
###H# #H#H######## #H# ##H##
###H#H#H#H#  G   # #H# ##H##
###H#H# #H# #### # #H#   H H
#G#H#H#H#H#H#P # # #H# ####H
#  H#H#H#H#H## # # #H# #H  H
 H#H#H#H#H#H  G# # #H# #H###
H### H#H#H###### # #H# #H  H
H## #H#H#H G     # #H -####H
H  -#H#H########## #H# #H  H
H## #H#H           #H# #H###
--# #H##############H# #H  H
     H      E       H# ####H
###################### E   H
