#######HH----------HH#######
######HH   -    -   HH######
#####HH     #EE#     HH#####
####HH    - #### -    HH####
###HH    - ###### -    HH###
##HH----- ######## -----HH##
#HH    - ####GG#### -    HH#
HH      ############      HH
#HH    - ####GG#### -    HH#
##HH    - ######## -    HH##
###HH    - ###### -    HH###
####HH    - #### -    HH####
#####HH    -    -    HH#####
######HH            HH######
#######HHE   P    EHH#######
############################
