       --          --    -- 
 ######G-H########H-G####G- 
 #######GH########HG######G 
 ########H########H######## 
 ### ####H###     H###   ## 
 ###  ###H###GGG  H###GGG-- 
 ###  ###H######  H######G- 
 ###  ###H######  H ######G 
 ###  ###H######  H  ###### 
 ### G###H###     H     ### 
 ###G####H###GGGGGH##GGG### 
 ########H########H##X##### 
 ####### H########H #X####  
 ######  H########H  X###   
  E  E   H   P    H   E  E  
#########W###HH###W#########
