####################
#   G    H   G     #
#  H###H###H#####  #
#  H#  H  #H       #
#  H# #H# #H  ######
# PH# #H# #H    G  #
# #H# #H# #####H#  #
#  H   H#---G  H  E#
#  H   H     H######
#  H   H-----H#    #
#  H --H           #
#  H   H    ##H    #
#  H   H      H    #
####################