                     EEE    
                  GGGGGGW   
           GGGGGGW#######   
    GGGGGGWSSSSSSS          
   W#######                 
   WW                       
    W                       
GGGGW                       
####H                       
##########H                 
###############H            
###################H        
######################H     
########################H   
#########################H  
#########################HP 
