GE     #####################
##H    #####################
H####H    ##################
H#######H E  ###############
H##### ####H    ############
H##### #######H    #########
H##### ##########H E  ######
H#### G ############H    ###
H####### G ############H    
H##### #### G #############H
H##### ####### G ##########H
H##### #########H G #######H
H##### #########H### ######H
HG   G   G   G #H### ######H
##############  H###      PH
############################
