                            
###W####         ------ E   
   W --  E            SSSSSH
   H#  #####H######---   # H
H####  #G---H-----#   ####H#
H      ####   ###H#   #G  H 
H      #----H----H#   #-  H 
H P#   #HG#GHG#HGH#   #   HG
#H##   ############   ##H###
 H    G#     G    #     H   
 H    ##   ###H   #     H   
 H  G# #      H   #G  H#####
 H  #  #   G  H   ##  H     
 HG#   # H######H # #GH     
 H#  G # H#  G #H    #H     
############################
