  E -- -             E      
####  H   -         ##H     
####  H ## -   E   -##H     
#GG#  H ##- #######  -H     
####  H     ####### H H###  
      H---  ####### H  #G#  
    -     H ####### H  ###  
     #### H ##GGG## H       
   - #### H ####### H       
###- #GG# H-     - -H       
#G#  #### H -   - H  ####   
###       H   P   H  ####   
          H  ###  H  #GG#   
   ##     H  #G#  H  ####   
   ##     H  #X#  H         
          H       H         
