                            
         E     E        G GW
      H##############  H####
      H ############  H#####
H######  #G##G##G##  H######
H#######           EH#######
H#############X#########    
H########G G    G G##### GG 
H#########X###X#############
H       E          G######  
H  H#####H#####H  -H####  GH
H  H  H  H  H  H   ###  GH##
H  HGGHGGHGGHGGH   #  GH####
H  H#####H#####H    GH######
H              P   H########
H###########################
