W                          W
W--------------------------W
HH                        HH
H  #X##    ###X##  ######  H
H  #  ##   #    #  #    X  H
H  #   ##  #       #       H
H  #    #  #       #       H
H  #   G#  #    G  #       H
H  #   ##  #   ##  #    G  H
H  #G ##   #   G#  #G  G#  H
H  ####    ###X##  ##X###  H
H      P                   H
H H######  ######  #H####  H
H H#   G#  ######H #H##G#  H
HEH#    # E## G##H  H####  H
############################
