##################W#########
# G               W# E G   #
#X###H####H   G   W#######H#
#X###H############## ###  H#
#    H  G E     #### ###  H#
#H#########H######## ###  H#
#H   ######H#####GG# ###G H#
#H   ######H##############H#
#H   #    GH    G  E   G #H#
#H   ###H#######H#######H#H#
#H  G###H       H#######H#H#
#H##X#  H    P  H  ##   H#H#
#H##X#H#####H########GG H#H#
#H##X#H#####H######G######H#
#HE   H##G##H    G  E     H#
############################
