###############            W
#             #            W
# ------------HH#######G   W
#             H#  G  # #---H
#G GE      P  H#     # #E  H
#H######HSSSSSS#SS   H  ## H
#H     #H      ###   H     H
#HG    #H-------   E #H    H
#H   ##SH      #######H   H#
#H  ##GSH    ###     #H#####
#H  #  SH  G##G# GG  #H## ##
#H##   SH  ##  #######H# # #
#H#G   SH ##   #-----#H## ##
#H     HHH#    #  G  #H#G# #
#H     H#H           #H## ##
############################
