
####################
####G#####H#######G#
#  H   H   H       #
#  H# #H# #H       #
#  H# #H# #H  ######
#  H  #H# #H    G  #
####H##H#######H####
#  H   H ----  H   #
#  H   H     H#    #
### H####----H######
G  H  -H           #
####   H    ##H    #
G      H      H    #
####################