SW#SSS#SS##S##SS#S SS#SS##S#
SHWWWWWSWS#SS#WSWWWWWWSS####
SH P GWSW GGG W W  E W G  W#
SHS#S#WSW#S##SH#HS###H####W#
SH G  WSW GGG H H G##H###SW#
SHS#SWWSW ### H H SSGHG##GW#
SHWWW GSW     HGH  #SHS#SSW#
SH  W##SW  G  HSH  G H----W#
SHG EW SW ### HSH  #SH  GS##
SH####HSW  #  HGH  # H ##GW#
SH  S HSWWWWWWHSH  # H   SHS
SH  S H---------HGE# HSGGGH#
SH  SGHS####H GSH###########
SH  S#HS   #####S#S-------H#
SH G  H  G   G       E GGGH#
S######S#SSSSSSSSSSSS#SSSSH#
