                      W     
                      W     
E       G#G           W#G   
#####H########H#H##########H
G   #H G      H#H    #     H
###H#####H##########H#H#####
G  H     H  E       H#H    G
#H##############H###########
GH##G  #      G#H    E #G   
#########H#########H########
##H     EH###G ##  H  ##  G#
##H####H#########H###H######
G H####H# G#####GH###H    ##
##H####H#########H######H###
##H   #H     # P H  #   H  G
############################
