 ----      GGGGGGG     ---- 
H    ##################    H
H SSS##################SSS H
H    ##################    H
HESH ################## HSEH
SSSH #    #    #    ### HSSS
   H #GGGG#GGGG#GGGG### H   
   H ################## H   
   H ################## H   
   H ################## H   
   H ###    #    #    # H   
   H ###GGGG#GGGG#GGGG# H   
   H ################## H   
   H ################## H   
   H ################## H   
   H                   PH   
