
####################
####G#####H#######G#
# PH   H   H       #
#  H# #H# #H     E #
#  H# #H# #H  ######
#  H  #H# #H    G  #
####H##H#######H####
#E H   H ----  H   #
#  H   H     H#    #
### H####----H######
GE H  -H      E    #
####   H    ##H    #
G      H      H    #
####################