 ----------  P   ---------- 
H    ----  ######  ----    H
H    --- ########## ---    H
H    -- ############ --    H
H    - #####GGGG##### -    H
H    - ############## -    H
H     ################     H
H     ##GGGG####GGGG##     H
H     ################     H
H     ######GGGG######     H
H      ##############      H
H    - ############## -    H
H    -  #GGGG##GGGG#  -    H
H    --  ##########  --    H
HEGGG---G  ######  G---GGGEH
#########HGGGGGGGGH#########
