HH #####EHSSS SSSHE##### HHS
HSHH G HHSHHHHHHHSHH G HHSHH
GHSH#H#HSHG##H##GHSH#H#HSHG#
# HSHHHSH # HHH # HSHHHSH #H
 #HHSHSHH# H   H #HHSHSHH#  
H# HHHHH #H ### H# HHHHH #H#
H#H     H#H# G #H#H     H#HP
H# HHHHH #H ### H# HHHHH #H#
 #HHSHSHH# H   H #HHSHSHH#  
X HSHHHSH # HHH # HSHHHSH #H
GHSH#H#HSHG##H##GHSH#H#HSHG#
HSHH G HHSHHHHHHHSHH G HHSHH
SH ##### HSSSHSSSH ##### HSS
SH H G H HSSHHHSSH H G H HSS
SH H#H#HEHHSHHHSHHEH#H#H HSS
HSHSHHHSHSHHHHHHHSHSHHHSHSHH
