W                          W
W                          W
W         E                W
H###X######################H
H###X######################H
H   G   ##--------##       H
H       G#H    E G##    E  H
H  ###  ##H ########  #####H
H  #G#  ##H       ##  ##G##H
H   P   ##H       ##  #####H
H  ###  ########HH##  ##G##H
H  ###  ########HH##  #####H
H  ###  ##      H ##       H
H  ###  ##     GH ##    G  H
##########H#########H#######
#######  GH###### G H#######
