 -                        - 
H ######################## H
H #    #  G  G#       #  # H
H # G  ####X###       #  # H
H #X####     # GE G   # G# H
H #   #      ############# H
H # G #      #      #    # H
H #####  G E #      #    # H
H #   #########     #  G # H
H #      #    #G  E ##X### H
H # G  G #    #######    # H
H ###X####    #   #      # H
H # G #G   EG #G  # G    # H
H ###X##########X######X## H
H           P      E       H
############################
