                  W         
    G             W         
#######H#######   W         
       H----------W    G    
       H    ##H   #######H##
       H    ##H          H  
     E H    ##H       GE H  
##H#####    ########H#######
  H                 H       
  H           E     H       
#########H##########H       
         H          H       
       G H----------H   G   
    H######         #######H
    H         P  G         H
############################
